11111111111111111111111111111111111111111
1E000000000010000000100000100010000000001
10111111111011111110101110101110101111101
10101000000000100010001000101000100000101
10101011111011101011111011101011111110111
10001010000010001000100010000000000010001
11111010111110111110101111111111101111101
10000010100000100000100000100000101000001
10111111101111101110111110101110111011101
10000000101010001000000010001000100010001
10111110101010111111111111111011101111111
10100010001010100000001000100010100000001
10101111111010101111101010101110101111101
10101000000010001000100010100010000000101
10101011111011111110111110111011111111101
10100010000000100010000010001000000010001
10101110111110101011101011101111111010111
10100010101000101000101000100000000010001
10111110101011101110111010111111111111101
100000001000000010000000100000000000000S1
11111111111111111111111111111111111111111
