// Initial position, dirty probability, random seed, map
5 4 0.01 1
O O O O O O O O O O
O - - - O O - - - O
O - O - - - - O - O
O O - - O - - - O O
O - - O O O - - - O
O O - - O - - - O O
O - O - - - - O - O
O - - O - - O - - O
O - - - - - - - - O
O O O O O O O O O O
