11111111111
1E100010001
10101111101
10100010001
10111010101
10001010101
10111010111
10100010001
10101111101
100000000S1
11111111111
