1111111111111111111111111111111111111111111111111111111111111
1E00000000001000000000000010000000000010000010001000101000001
1011111110101011111111101011111110111011101010101010101010101
1000000010101000000010001010001000101000001010101010100010101
1111111010111111101110111010101011101111111010101010111110101
10000000100000000010001000001000100000000000001000100000001S1
1111111111111111111111111111111111111111111111111111111111111
